# 0 -> invalid square
# 1 -> valid square
# 2 -> starting point
# 3 -> ending point

2,1,1,1,1,0,1,1,1
0,0,1,0,1,1,1,0,1
3,0,1,1,0,0,1,0,1
1,1,0,1,1,0,1,0,1
0,1,0,1,0,1,1,0,1
0,1,0,1,1,0,1,0,1
1,1,0,0,0,1,1,0,1
1,0,1,1,1,0,0,1,1
1,0,1,0,1,0,1,1,0
1,1,1,0,1,1,1,0,0
